-#------#-
-##-----#-
-##-----#-
-#--------
---####---
----------
------#--#
-#-------#
-----##--#
---------#